front_col,left_col,right_col,rear_col,num_cols,avg_speed,avg_time_taken,time_limit_reached
0,0,0,0,0,0.8472379953242265,16.32,0
0,0,1,0,1,-0.3514129873299552,65.152,0
0,0,1,1,2,-0.12741481355918102,18.432,0
1,0,1,1,3,-0.03963044803266833,8.832,0
1,0,1,1,3,0.07600455719856447,21.92,0
1,0,1,1,3,-0.6399895065142323,109.72800000000001,0
1,0,1,1,3,-0.517895502711602,12.672,0
1,0,1,1,3,-0.5463727729462581,35.392,0
1,0,1,1,3,-0.4496510329323866,9.568,0
1,0,1,1,3,-0.5380878163578238,52.032000000000004,0
2,0,1,1,4,-0.5368420436498318,40.096000000000004,0
3,0,1,1,5,-0.5539500809593852,50.24,0
3,0,1,1,5,-0.48765734959379475,11.008000000000001,0
3,1,1,1,6,-0.6739145492448607,111.00800000000001,0
3,1,1,1,6,-0.6726851814009567,46.048,0
4,1,1,1,7,-0.6679695016067425,35.87200000000001,0
4,1,1,1,7,-0.6178676866083476,11.52,0
4,2,1,1,8,-0.5997978149790332,8.704,0
4,2,1,1,8,-0.5523273681435716,11.488,0
4,2,2,1,9,-0.5075914748876958,43.84,0
5,2,2,1,10,-0.5130136582752459,33.312000000000005,0
5,2,2,1,10,-0.47494386974811476,14.496,0
5,2,3,1,11,-0.47398109524743787,35.36000000000001,0
5,2,3,1,11,-0.43689291156860677,10.016,0
5,2,3,1,11,-0.4644043042604242,43.456,0
5,2,4,1,12,-0.44447883232065905,60.992000000000004,0
5,3,4,1,13,-0.49018396318323787,49.216,0
5,3,5,1,14,-0.49612930345733497,33.344,0
5,3,5,1,14,-0.4951845474387247,25.024,0
5,3,6,1,15,-0.5036958426554208,34.528000000000006,0
5,3,6,2,16,-0.5087992006956348,75.04,0
5,3,6,3,17,-0.5198544946859832,40.96,0
6,3,6,3,18,-0.5050738759537861,12.96,0
6,3,6,4,19,-0.5290982835493216,47.48800000000001,0
6,3,6,4,19,-0.5206382629880972,62.080000000000005,0
6,4,6,4,20,-0.6111981456357347,146.88,0
6,4,6,5,21,-0.6218773293110862,40.416000000000004,0
6,4,6,5,21,-0.6016364914571121,10.4,0
6,4,7,5,22,-0.6053327138652118,33.056000000000004,0
6,4,8,5,23,-0.6082119462260283,31.84,0
6,4,8,5,23,-0.5879886367375106,10.176,0
6,4,8,5,23,-0.5699424288668243,8.512,0
6,4,8,6,24,-0.5516714455062912,28.128,0
6,4,9,6,25,-0.571720947621535,96.48,0
6,4,9,6,25,-0.554810077100206,10.496,0
6,4,9,6,25,-0.5374196394305247,13.952,0
7,4,9,6,26,-0.553339284989481,65.12,0
7,4,9,6,26,-0.5553130258068748,37.312000000000005,0
7,4,9,6,26,-0.5387866043254531,9.984,0
7,4,9,7,27,-0.5482507723158727,46.336000000000006,0
7,4,9,7,27,-0.6227567404410282,150.016,1
7,4,9,7,27,-0.6077008909575088,15.168000000000001,1
7,4,9,7,27,-0.606263452883693,18.944,1
7,4,9,8,28,-0.6214508559968842,64.70400000000001,1
7,4,9,8,28,-0.6099506418214385,17.92,1
7,4,9,8,28,-0.5917511487990756,25.792,1
7,4,9,8,28,-0.5778670324708378,10.24,1
7,4,9,8,28,-0.5631154437538469,11.936,1
7,4,9,9,29,-0.5709914618408041,48.672000000000004,1
7,5,9,9,30,-0.568682298062796,34.176,1
7,5,9,10,31,-0.5800580091610086,51.264,1
7,5,10,10,32,-0.5704340484440746,62.784000000000006,1
7,5,10,10,32,-0.5578738561611324,9.44,1
7,5,10,10,32,-0.54468392767585,17.6,1
8,5,10,10,33,-0.5383662818426673,7.6160000000000005,1
8,5,10,10,33,-0.5265486371897835,11.296,1
9,5,10,10,34,-0.5173218712825671,46.752,1
9,6,10,10,35,-0.514736403473299,69.34400000000001,1
9,6,10,10,35,-0.5129114301928763,19.776,1
9,6,10,10,35,-0.5041981428644705,21.792,1
9,6,10,10,35,-0.5091814485725727,61.34400000000001,1
9,6,10,10,35,-0.5190204262539339,47.55200000000001,1
9,6,11,10,36,-0.5169031018841478,67.072,1
9,7,11,10,37,-0.5429180245604033,102.08000000000001,1
9,7,11,10,37,-0.5417266832909094,25.152,1
9,7,11,11,38,-0.5974058193831051,140.896,1
9,7,11,11,38,-0.5864451680920806,19.744,1
9,7,11,11,38,-0.5906095021642034,67.424,1
9,7,11,11,38,-0.5797477142307841,12.032,1
9,7,11,11,38,-0.5748913771576509,38.016000000000005,1
9,7,11,12,39,-0.5967238143077059,99.552,1
9,7,11,13,40,-0.5970271559885274,57.856,1
9,7,11,14,41,-0.5886324198116353,75.456,1
9,8,11,14,42,-0.5851580367033073,4.5760000000000005,1
9,8,11,15,43,-0.5949010709617253,65.76,1
9,8,11,15,43,-0.5867942047003304,17.312,1
9,8,11,16,44,-0.5710099055948067,52.25600000000001,1
9,8,11,16,44,-0.5791916420657957,70.528,1
9,8,11,16,44,-0.5718372943314617,18.016000000000002,1
10,8,11,16,45,-0.5706085945789484,41.088,1
10,8,11,16,45,-0.5884872531818817,95.872,1
10,8,11,17,46,-0.6072556461989547,64.768,1
10,8,11,18,47,-0.5978994340336384,15.808,1
10,8,11,19,48,-0.6028189286120017,39.168000000000006,1
10,8,11,19,48,-0.606331808685795,35.80800000000001,1
10,8,11,19,48,-0.6371194846730868,143.26399999999998,1
10,8,11,19,48,-0.6294262178213277,34.24,1
10,8,11,20,49,-0.6301432286619938,37.120000000000005,1
10,8,12,20,50,-0.6284305741208993,27.104,1
10,8,12,21,51,-0.648657828975881,71.39200000000001,1
10,8,12,22,52,-0.6494564989686223,62.848000000000006,1
10,8,12,22,52,-0.6415908546142195,21.056,1
10,8,12,22,52,-0.640594509671638,21.728,1
10,8,12,22,52,-0.6335348014604182,10.656,1
10,8,13,22,53,-0.6337500556609849,33.088,1
10,8,13,23,54,-0.62857044449356,17.472,1
10,8,13,23,54,-0.6211254506835878,17.344,1
10,8,13,23,54,-0.613407703169735,19.584,1
10,9,13,23,55,-0.6157060066257444,34.720000000000006,1
10,9,13,23,55,-0.609064820922197,15.904,1
10,9,13,23,55,-0.60028296858729,23.456,1
10,9,13,23,55,-0.5932818796689802,13.792,1
10,9,13,23,55,-0.5917141229348549,22.432000000000002,1
10,9,13,23,55,-0.5954403790703942,38.944,1
10,9,13,24,56,-0.5813800832817078,59.232000000000006,1
10,9,13,25,57,-0.5758858204530222,19.424,1
10,9,13,25,57,-0.5979580592843028,123.90400000000001,1
10,9,14,25,58,-0.5988748610444163,68.512,1
10,10,14,25,59,-0.5969387219500509,31.904,1
10,10,15,25,60,-0.5965457122631694,33.504000000000005,1
10,11,15,25,61,-0.5938530964349463,4.896,1
10,11,15,25,61,-0.5869610482785801,15.36,1
10,11,15,25,61,-0.5803277104566039,17.664,1
10,12,15,25,62,-0.5830462701483593,47.456,1
10,12,15,25,62,-0.5777297197748917,15.232000000000001,1
10,12,15,25,62,-0.5719644302612582,16.736,1
10,12,15,25,62,-0.5718235166830034,34.496,1
10,13,15,25,63,-0.5691859711568712,18.016000000000002,1
10,13,15,25,63,-0.5632426375059867,14.88,1
10,13,15,25,63,-0.5585214994152548,15.776,1
10,13,16,25,64,-0.5593669058489061,36.800000000000004,1
10,14,16,25,65,-0.5672885773404791,84.224,1
11,14,16,25,66,-0.5651960106174995,4.896,1
11,14,16,25,66,-0.5595433558336628,9.824,1
11,14,16,25,66,-0.5629006063896919,36.032000000000004,1
11,14,16,25,66,-0.5569658493314539,12.672,1
11,14,16,25,66,-0.55264551787918,16.288,1
11,14,16,25,66,-0.546867354104711,10.272,1
11,14,16,25,66,-0.5412706930528337,9.344,1
11,14,16,25,66,-0.5410882161112138,21.312,1
11,14,16,25,66,-0.5358288875026707,17.28,1
11,14,16,25,66,-0.542266421290077,62.816,1
11,14,16,25,66,-0.5451334289910912,36.06400000000001,1
11,14,16,26,67,-0.5474246302718564,48.416000000000004,1
11,14,16,26,67,-0.5429538274304456,18.048000000000002,1
11,14,16,26,67,-0.5366493869997008,13.44,1
11,14,16,26,67,-0.5311176385466347,17.248,1
11,15,16,26,68,-0.5501882834622839,107.552,1
11,15,16,26,68,-0.544392652385835,17.664,1
11,15,16,26,68,-0.5392249836994563,13.664,1
11,16,16,26,69,-0.5421061599587684,33.440000000000005,1
11,16,16,27,70,-0.5404928521116937,72.41600000000001,1
11,16,16,27,70,-0.5355474726411696,10.272,1
11,16,16,27,70,-0.5308383427714902,16.672,1
11,17,16,27,71,-0.5287980614114588,74.49600000000001,1
11,17,16,28,72,-0.5348503320585006,58.080000000000005,1
11,17,16,29,73,-0.5375391346065885,42.720000000000006,1
11,17,16,29,73,-0.5327897186611967,9.312,1
11,17,16,30,74,-0.53904268185542,63.36000000000001,1
11,17,16,30,74,-0.5408505516883596,65.47200000000001,1
11,17,16,31,75,-0.5368026577167978,19.2,1
11,17,16,32,76,-0.5394957036801203,44.416000000000004,1
11,17,16,32,76,-0.5338656132456254,22.752,1
11,17,16,32,76,-0.542238787720426,54.56,1
11,17,17,32,77,-0.5433351817649189,32.832,1
12,17,17,32,78,-0.5432164753030937,68.32000000000001,1
12,17,17,32,78,-0.5384506601940734,14.112,1
12,17,17,33,79,-0.5398081023381995,52.83200000000001,1
12,17,17,33,79,-0.5348936055748632,12.8,1
12,17,17,34,80,-0.5356519618721591,73.632,1
12,17,18,34,81,-0.5362321205962383,36.25600000000001,1
12,17,18,34,81,-0.5369738447505629,42.432,1
12,17,18,34,81,-0.5328015599684359,18.048000000000002,1
12,17,18,34,81,-0.528499313260783,17.856,1
12,17,18,34,81,-0.531501533122208,52.096000000000004,1
12,17,18,34,81,-0.5271031088523987,18.176000000000002,1
12,17,18,34,81,-0.5236995534466988,17.888,1
12,17,18,34,81,-0.5192331078957404,10.336,1
12,17,18,34,81,-0.5150981558908654,13.376,1
12,17,18,34,81,-0.5114113966444176,11.552,1
12,17,18,34,81,-0.52236167586451,116.03200000000001,1
12,17,18,34,81,-0.5183364499648471,17.696,1
12,17,18,34,81,-0.5144808428831684,16.48,1
12,17,19,34,82,-0.5149945568802322,35.008,1
12,17,19,34,82,-0.5193018550417698,51.87200000000001,1
12,17,20,34,83,-0.5211296162812009,50.400000000000006,1
12,17,20,35,84,-0.5234859596053716,40.352000000000004,1
12,17,20,35,84,-0.5190781563606676,12.768,1
13,17,20,35,85,-0.5175712148308523,4.448,1
13,17,20,35,85,-0.5138863578309324,15.168000000000001,1
13,18,20,35,86,-0.5121345523663513,4.64,1
13,18,20,36,87,-0.5115698261322368,41.472,1
13,18,20,36,87,-0.5110637859063032,21.248,1
13,18,20,37,88,-0.5153644653990537,63.2,1
14,18,20,37,89,-0.5135518715360337,10.08,1
14,19,20,37,90,-0.5200081785369097,99.52000000000001,1
14,19,20,37,90,-0.5160102904441979,12.48,1
14,20,20,37,91,-0.5144628859284752,4.48,1
14,20,20,37,91,-0.5105333163143448,9.6,1
14,20,21,37,92,-0.5076934919364064,63.93600000000001,1
14,20,21,38,93,-0.511259844178243,49.856,1
14,20,21,38,93,-0.5069606217014698,13.824,1
14,20,21,38,93,-0.5027074423249815,10.464,1
14,20,21,38,93,-0.49873155551073556,10.144,1
14,20,21,38,93,-0.4948749837267498,10.464,1
14,20,21,39,94,-0.4988715714880376,81.31200000000001,1
14,20,21,40,95,-0.5003298811166033,37.216,1
14,21,21,40,96,-0.5215756013660194,121.44000000000001,1
14,21,21,40,96,-0.5177304773471864,18.784,1
14,21,21,40,96,-0.5143986858091852,16.16,1
14,21,21,40,96,-0.5105273231367388,9.312,1
15,21,21,40,97,-0.5090968045496254,4.8,1
15,21,21,41,98,-0.5142952121664496,88.41600000000001,1
15,22,21,41,99,-0.513550989536301,86.464,1
15,22,21,41,99,-0.5098791564041611,9.696,1
15,22,21,41,99,-0.505972520685873,20.416,1
15,22,22,41,100,-0.5060565172180714,33.760000000000005,1
15,23,22,41,101,-0.5035492387638546,71.104,1
15,23,22,41,101,-0.5039915279359282,36.352000000000004,1
15,23,22,41,101,-0.5198220862210805,107.712,1
15,23,22,42,102,-0.5160603847924744,49.312000000000005,1
15,23,22,43,103,-0.5226389822721274,109.536,1
16,23,22,43,104,-0.5214509742880807,46.464000000000006,1
16,23,22,43,104,-0.5257557504632112,73.47200000000001,1
16,23,22,43,104,-0.5230582715721834,20.992,1
16,23,22,43,104,-0.5239941192137558,39.008,1
16,23,22,43,104,-0.5251224059714631,38.528000000000006,1
16,23,22,44,105,-0.5263194969399069,41.312000000000005,1
16,23,22,44,105,-0.5260874291564933,21.76,1
16,24,22,44,106,-0.5247138201813318,4.864,1
16,24,22,44,106,-0.5211864285721137,12.224,1
16,24,22,44,106,-0.517834845729835,10.016,1
16,24,22,44,106,-0.5148477612118924,16.736,1
16,25,22,44,107,-0.5183519074752405,60.19200000000001,1
16,25,22,44,107,-0.5236699646693853,109.69600000000001,1
16,26,22,44,108,-0.5196931434469879,12.704,1
16,26,22,45,109,-0.5246575501914386,95.168,1
16,26,22,46,110,-0.5208615983763085,25.248,1
16,27,22,46,111,-0.5242098381365816,44.70400000000001,1
16,27,22,46,111,-0.5251258090451949,39.456,1
16,27,22,47,112,-0.5271423763501867,39.776,1
16,27,22,47,112,-0.5231409072060201,21.824,1
16,27,22,47,112,-0.5198376673065196,15.808,1
16,27,22,47,112,-0.5167863456277638,19.488,1
16,27,23,47,113,-0.513576265310951,17.312,1
17,27,23,47,114,-0.513167639413717,53.632000000000005,1
17,27,23,48,115,-0.5149608233527558,42.528000000000006,1
17,27,23,49,116,-0.5176946380067796,79.77600000000001,1
17,27,23,50,117,-0.5196901409026753,39.84,1
17,27,23,50,117,-0.5226273721975869,90.304,1
18,27,23,50,118,-0.5217860717502462,37.152,1
