front_col,left_col,right_col,rear_col,num_cols,avg_speed,avg_time_taken,time_limit_reached
0,0,0,0,0,1.4322723337754546,39.2,0
0,0,0,0,0,1.7935986207981576,5.024,0
0,0,0,0,0,2.215021416610687,20.768,0
0,1,0,0,1,2.0961889158216573,67.64800000000001,0
0,1,0,0,1,2.0919657978592183,108.16000000000001,0
0,1,0,0,1,2.203445794612636,18.496,0
0,2,0,0,2,2.1493204666744044,32.51200000000001,0
0,2,0,0,2,2.1167106020047997,33.216,0
0,2,0,0,2,1.9640846534141847,149.696,0
0,2,1,0,3,1.993096969645445,11.552,0
0,2,1,0,3,2.007869891547585,5.312,0
0,2,1,0,3,2.0261965472456227,4.352,0
0,2,1,0,3,1.7634667549447098,126.272,0
0,3,1,0,4,1.7666470416037436,27.296,0
0,3,1,0,4,1.759272011292645,42.400000000000006,0
0,3,1,0,4,1.6758636527805755,150.016,1
0,3,1,0,4,1.698348625384198,50.24,1
0,4,1,0,5,1.7229821415890367,12.736,1
0,4,1,0,5,1.7496126551558384,23.616,1
0,4,1,0,5,1.7781673394110644,27.264,1
0,4,1,0,5,1.7593546502297248,74.528,1
0,4,1,0,5,1.7742566663214177,84.992,1
0,5,1,0,6,1.8157767064993025,138.688,1
1,5,1,0,7,1.822442454611982,5.5680000000000005,1
1,5,1,0,7,1.8535795336340601,116.80000000000001,1
1,5,1,0,7,1.7634007060381895,150.016,2
2,5,1,0,8,1.7777692961306035,10.4,2
2,5,1,0,8,1.7930382499428295,22.72,2
2,5,1,0,8,1.786565762688143,108.03200000000001,2
2,5,1,0,8,1.8053331332163582,61.184000000000005,2
2,5,1,0,8,1.8243406236173634,19.168,2
2,6,1,0,9,1.8260176315420633,45.024,2
2,6,1,0,9,1.8014200676527865,67.26400000000001,2
2,6,1,0,9,1.775083844699941,129.952,2
2,6,1,0,9,1.8045808841123376,150.016,3
2,6,1,0,9,1.7271622570538592,132.576,3
2,7,1,0,10,1.736131774800644,36.12800000000001,3
2,7,1,0,10,1.7414842475554915,27.04,3
2,7,2,0,11,1.749055688132999,30.208000000000002,3
2,7,2,0,11,1.766692843917545,38.688,3
2,7,2,0,11,1.7671191871132796,56.51200000000001,3
2,7,2,0,11,1.7671292854691654,64.736,3
2,7,2,0,11,1.7608997286837968,47.072,3
3,7,2,0,12,1.7737960671112531,117.408,3
3,7,2,0,12,1.7842687268952822,18.56,3
3,7,2,0,12,1.7984429044424695,67.808,3
3,7,2,0,12,1.8086951341776987,52.288000000000004,3
3,7,2,0,12,1.8182007116169188,22.208000000000002,3
4,7,2,0,13,1.8313452520746702,33.312000000000005,3
4,7,2,0,13,1.8418021290509852,60.608000000000004,3
5,7,2,0,14,1.8446340153304075,5.344,3
5,7,2,0,14,1.8364526108732868,121.98400000000001,3
5,7,2,1,15,1.8423718874275448,12.48,3
5,7,2,1,15,1.8463754577954348,46.272000000000006,3
5,8,2,1,16,1.8555189856515426,26.432000000000002,3
5,8,2,1,16,1.8592113752121215,4.96,3
5,8,2,1,16,1.862909614976364,48.992000000000004,3
6,8,2,1,17,1.863421326636267,21.888,3
6,8,3,1,18,1.8657918775369278,29.504,3
6,8,3,1,18,1.8666745921455858,74.816,3
6,8,3,1,18,1.8400511811488274,150.016,4
6,8,3,1,18,1.8537921266510766,150.016,5
6,8,3,1,18,1.8598746726131477,60.800000000000004,5
6,8,3,1,18,1.8627296098613766,34.080000000000005,5
6,8,3,1,18,1.857425482263704,44.83200000000001,5
7,8,3,1,19,1.8601298863777094,59.136,5
7,8,3,1,19,1.8544879679379818,135.93599999999998,5
7,8,3,1,19,1.8063439805584647,126.59200000000001,5
7,8,3,1,19,1.8120036835604572,143.584,5
8,8,3,1,20,1.8144133465678483,5.792,5
8,8,3,1,20,1.8092666865059182,83.232,5
8,8,3,1,20,1.8020123597524131,59.392,5
8,9,3,1,21,1.7921461403225014,43.648,5
8,9,3,1,21,1.789981975539184,44.64000000000001,5
8,9,3,1,21,1.8033154524924302,32.288000000000004,5
8,9,3,1,21,1.8031862436493618,144.096,5
8,9,3,1,21,1.8090205791990375,111.616,5
8,10,3,1,22,1.810575488294915,5.632,5
8,10,3,2,23,1.8169264845277633,34.432,5
8,10,3,2,23,1.8231869227852793,17.824,5
8,10,3,2,23,1.8207454816495745,68.0,5
8,10,3,3,24,1.823220993449275,34.784000000000006,5
8,10,3,3,24,1.827090722683573,8.352,5
8,10,3,3,24,1.7944429453948216,150.016,6
8,10,3,3,24,1.7842875453126759,140.896,6
8,10,3,3,24,1.7798737008635674,150.016,7
9,10,3,3,25,1.7815988779940566,5.408,7
9,10,3,3,25,1.7706424574606061,70.176,7
9,10,3,3,25,1.746605650181346,110.56,7
9,10,3,3,25,1.7517569481261281,83.968,7
9,10,3,3,25,1.7575328597585052,18.464,7
9,10,3,3,25,1.757994578780183,35.072,7
9,10,3,3,25,1.7581685699657787,62.144000000000005,7
9,10,3,3,25,1.7627843684416082,18.112000000000002,7
9,10,3,3,25,1.7650309420474268,4.5760000000000005,7
9,10,4,3,26,1.7634145195931634,29.92,7
9,10,4,3,26,1.74658051856682,150.016,8
9,10,4,3,26,1.7189854661412582,130.49599999999998,8
9,10,4,3,26,1.723348286752004,37.28,8
9,10,4,3,26,1.7254649191578577,4.736,8
9,10,4,3,26,1.6949020272416626,150.016,9
9,10,4,3,26,1.6928827516999891,47.968,9
9,10,4,3,26,1.6965844345110774,56.83200000000001,9
9,10,4,3,26,1.6987464583572682,4.736,9
9,10,4,3,26,1.7006533021452985,4.768,9
9,10,4,3,26,1.6867501080417155,124.92800000000001,9
9,10,4,3,26,1.6887794227236705,4.5440000000000005,9
9,10,4,3,26,1.6909527882744315,110.016,9
9,10,4,3,26,1.6774527139413522,150.016,10
9,10,4,3,26,1.6810492593386666,22.208000000000002,10
9,10,4,3,26,1.6846410209157783,81.152,10
9,10,4,3,26,1.682139456469816,114.784,10
9,10,4,3,26,1.6741918877752069,106.88000000000001,10
9,10,4,4,27,1.6808321238449548,44.032000000000004,10
9,10,4,4,27,1.685346666285211,22.976,10
9,10,4,4,27,1.6886255136096018,124.512,10
10,10,4,4,28,1.6935316325690022,19.328,10
10,10,4,4,28,1.6952535525560208,4.704,10
10,10,4,4,28,1.6982237350000757,14.304,10
10,10,4,4,28,1.7007906200160063,25.344,10
10,10,4,4,28,1.702361349101503,4.896,10
10,10,4,4,28,1.7060829061285683,24.032,10
10,10,4,4,28,1.6841968019194777,134.84799999999998,10
10,10,4,4,28,1.6822176279896563,34.592000000000006,10
10,10,4,4,28,1.684759090798879,14.048,10
10,10,4,4,28,1.6850451081547975,98.88000000000001,10
10,10,4,4,28,1.6859674111152652,52.25600000000001,10
11,10,4,4,29,1.687402990580017,5.376,10
11,10,5,4,30,1.6867850912303097,74.784,10
12,10,5,4,31,1.6880221787311875,5.5360000000000005,10
12,10,5,4,31,1.6896146657405902,4.768,10
12,10,5,4,31,1.69519673447363,30.304000000000002,10
12,10,5,4,31,1.694776166917445,75.584,10
12,10,5,4,31,1.6938263536825349,150.016,11
12,10,5,4,31,1.6989299510347977,38.432,11
12,10,5,4,31,1.7005250569186723,4.736,11
12,10,5,4,31,1.6981627420650962,61.536,11
13,10,5,4,32,1.6993307390294223,5.472,11
13,10,5,4,32,1.7057629088344175,66.24000000000001,11
13,10,5,4,32,1.70989281498262,44.38400000000001,11
13,10,5,4,32,1.7115458220779924,4.64,11
13,10,5,4,32,1.6929460032124777,138.112,11
13,10,6,4,33,1.700683946124719,89.408,11
13,10,6,4,33,1.699926190631608,41.6,11
13,10,6,4,33,1.704014338909748,150.016,12
13,10,6,4,33,1.7080871548352972,41.536,12
13,10,6,4,33,1.7068992192436203,41.152,12
13,10,6,4,33,1.709016408457052,19.488,12
13,10,6,4,33,1.7109387414682629,29.472,12
13,10,6,4,33,1.7176524997796114,147.2,12
13,10,6,4,33,1.7203573190693588,65.92,12
13,10,6,4,33,1.7219344963320946,4.352,12
13,10,6,5,34,1.729020490412503,40.06400000000001,12
13,10,7,5,35,1.7370227380777188,52.89600000000001,12
13,10,7,5,35,1.7414207040287846,114.432,12
13,10,7,5,35,1.7423388252888117,32.928000000000004,12
13,10,7,5,35,1.742981361159937,34.464000000000006,12
13,10,7,5,35,1.7336955727217378,150.016,13
13,10,7,5,35,1.7335914870466649,53.344,13
13,10,7,5,35,1.7333103792108584,98.528,13
13,10,7,5,35,1.7335365826727207,62.88,13
13,10,7,5,35,1.721600692804588,150.016,14
13,10,7,6,36,1.7239335075669173,12.736,14
13,10,7,6,36,1.7123656384726456,150.016,15
13,10,7,6,36,1.7126741166778747,39.42400000000001,15
13,10,7,6,36,1.7052449908914236,141.344,15
13,10,7,6,36,1.703770543171834,45.152,15
13,10,7,6,36,1.7049360735793624,4.8,15
13,10,7,6,36,1.7044820285375222,45.952000000000005,15
13,10,8,6,37,1.7067728058259763,67.39200000000001,15
13,10,8,6,37,1.710859556040003,39.29600000000001,15
14,10,8,6,38,1.7147204183888676,36.800000000000004,15
14,10,8,6,38,1.711210279527782,89.60000000000001,15
14,10,9,6,39,1.7110374748826143,26.624,15
14,10,9,6,39,1.7132145380472963,42.304,15
14,11,9,6,40,1.7173059411094405,94.048,15
14,11,9,6,40,1.7156931492672967,66.432,15
14,11,9,6,40,1.707360437807215,150.016,16
14,11,9,7,41,1.7087274959178527,13.184000000000001,16
14,11,9,7,41,1.7143329421298799,62.784000000000006,16
14,11,9,7,41,1.7138134960875424,110.88000000000001,16
14,11,9,7,41,1.7091516576844585,76.32000000000001,16
14,11,9,7,41,1.7158304240892408,150.016,17
14,11,9,7,41,1.7114113270692437,150.016,18
14,11,9,7,41,1.7149426517778315,150.016,19
14,11,9,7,41,1.7171338334436466,22.080000000000002,19
14,11,9,7,41,1.713009882613156,109.92,19
14,11,9,7,41,1.7141579137374108,4.5440000000000005,19
14,11,9,7,41,1.7141811397861062,43.328,19
14,11,9,7,41,1.7136698053189712,74.4,19
14,11,9,7,41,1.7172411622481245,61.312000000000005,19
14,11,9,7,41,1.7149511650792433,48.70400000000001,19
14,11,9,7,41,1.7163346150450762,19.776,19
14,11,9,7,41,1.7140123883128504,106.784,19
14,11,9,7,41,1.7122190323574813,52.672000000000004,19
14,11,9,7,41,1.7115840101444895,35.104000000000006,19
14,11,9,7,41,1.7113863325227918,39.904,19
14,11,9,7,41,1.7133618404345201,22.464000000000002,19
14,11,9,7,41,1.7026565226764037,150.016,20
14,11,9,7,41,1.702247062168441,41.024,20
14,11,9,7,41,1.7052782031001892,22.080000000000002,20
14,11,9,7,41,1.7044165300973337,42.528000000000006,20
14,11,9,7,41,1.7081437468471876,107.552,20
14,11,9,7,41,1.711031164505281,50.752,20
14,11,9,7,41,1.7111722674376957,60.64000000000001,20
15,11,9,7,42,1.7136514296475926,119.232,20
15,11,9,7,42,1.71485329695981,84.768,20
15,11,9,7,42,1.7154730604490276,123.616,20
15,11,9,7,42,1.716231221117486,66.464,20
15,11,9,7,42,1.7179098555753576,25.536,20
15,11,10,7,43,1.7190766291467112,16.48,20
15,11,10,7,43,1.7056703574985244,150.016,21
15,11,10,7,43,1.7073468503357092,28.96,21
15,11,10,7,43,1.7077715832084075,92.44800000000001,21
15,11,10,7,43,1.707531952640494,35.648,21
16,11,10,7,44,1.7091345472221358,10.816,21
16,11,10,7,44,1.7118822652816303,72.44800000000001,21
16,11,10,8,45,1.711663894269552,47.93600000000001,21
16,11,10,9,46,1.7120887561863845,11.52,21
16,11,10,9,46,1.7130950014032993,4.5440000000000005,21
16,11,11,9,47,1.7148487025540908,32.928000000000004,21
16,11,11,9,47,1.7172295848326644,65.60000000000001,21
16,11,12,9,48,1.7163135899746862,123.936,21
16,11,12,9,48,1.710391195621288,83.2,21
16,11,12,9,48,1.7075431806389283,90.11200000000001,21
16,11,12,9,48,1.70556838438742,76.19200000000001,21
16,11,12,9,48,1.704386048565198,150.016,22
16,11,12,9,48,1.705860053853515,21.312,22
16,11,12,9,48,1.7067132086915837,40.928000000000004,22
17,11,12,9,49,1.7089299647946796,19.296,22
17,12,12,9,50,1.7102463650646773,12.64,22
17,13,12,9,51,1.708501084085807,42.784000000000006,22
17,13,12,9,51,1.707922304980636,73.47200000000001,22
17,13,12,9,51,1.7087923726888823,9.312,22
17,13,12,9,51,1.7086307566259598,24.448,22
17,13,12,9,51,1.707616168654695,141.088,22
17,13,12,9,51,1.7109677008874757,150.016,23
17,13,12,9,51,1.708989670420461,54.720000000000006,23
17,13,12,9,51,1.7118464373408475,39.648,23
17,14,12,9,52,1.7154365356394665,39.52,23
17,14,12,9,52,1.7163088923157566,4.5760000000000005,23
17,14,12,9,52,1.7177719486872296,13.92,23
17,15,12,9,53,1.7095746683433852,103.872,23
17,15,12,9,53,1.712438516984149,139.2,23
17,15,12,10,54,1.7137515902480809,12.928,23
17,15,12,10,54,1.7154091109121732,50.016000000000005,23
17,15,12,10,54,1.713160025251891,62.112,23
17,15,12,10,54,1.7148781078727464,21.472,23
17,15,12,11,55,1.7150150646472562,146.144,23
17,15,12,11,55,1.7168412501926933,18.176000000000002,23
17,15,12,11,55,1.72009108775216,30.944,23
